AUTREYA = Alex Autrey <Alex.Autrey@crlcorp.com>
EMERYS = EMERYS <>
Hendersonc = Hendersonc <>
HoferMX = Melania Hofer <Melania.Hofer2@crlcorp.com>
MEDIKED = MEDIKED <>
OLETIS = Sunil Oleti <Sunil.Oleti@crlcorp.com>
RosenbergJ = Justin Rosenberg <Justin.Rosenberg@crlcorp.com>
Rosenbergj = Justin Rosenberg <Justin.Rosenberg@crlcorp.com>
WHITEA = WHITEA <>
abdelmajeedm = abdelmajeedm <>
ahmeda = ahmeda <>
albakhietm = albakhietm <>
andersons = andersons <>
andreeve = andreeve <>
arokiarajj = arokiarajj <>
autreya = Alex Autrey <Alex.Autrey@crlcorp.com>
bandas = Srinivas Banda <Srinivas.Banda@crlcorp.com>
barouqam = Musa Barouqa <Musa.Barouqa@crlcorp.com>
beckmanj = beckmanj <>
billst = Trent Bills <trent.bills@crlcorp.com>
blaess = blaess <>
bluhma = bluhma <>
bluhmr = Roger Bluhm <Roger.Bluhm@crlcorp.com>
bollwittt = bollwittt <>
builder = builder <>
bushe = bushe <>
campbellj = campbellj <>
carboneaur = carboneaur <>
ccontrol = ccontrol <>
cheungr = cheungr <>
cooperkx = Kyle Cooper <Kyle.Cooper@crlcorp.com>
crljenkins = crljenkins <>
cudnikj = cudnikj <>
dandaj = dandaj <>
davisonj = davisonj <>
davisr = Rachel Davis <noreply@crlcorp.com>
daviss = Sean Davis <Sean.Davis@crlcorp.com>
deskor = deskor <>
devarakondas = devarakondas <>
emerys = emerys <>
ernstl = ernstl <>
everestb = everestb <>
fernandol = fernandol <>
gaisand = gaisand <>
gandhik = Komal Gandhi <Komal.Gandhi@crlcorp.com>
grangerl = grangerl <>
griffisa = griffisa <>
haasr = haasr <>
harrisr = harrisr <>
hendersonc = hendersonc <>
hewittr = Richard Hewitt <Richard.Hewitt@crlcorp.com>
hoferm = hoferm <>
hofermx = Melania Hofer <Melania.Hofer2@crlcorp.com>
jacksonr = Robyn Jackson <Robyn.Jackson@crlcorp.com>
jilania = jilania <>
jtmtest = jtmtest <>
karuppananp = Pasumponni Karuppanan <Pasumponni.Karuppanan@crlcorp.com>
keenej = Jon Keene <Jon.Keene@crlcorp.com>
kennedyw = Wyatt Kennedy <Wyatt.Kennedy@crlcorp.com>
kierasd = kierasd <>
kochersperc = kochersperc <>
lairej = lairej <>
lapidm = Marvin Lapid <noreply@crlcorp.com>
leec = Cheng-Yeh Lee <Cheng-Yeh.Lee@crlcorp.com>
lewisr = lewisr <>
lij = lij <>
limerb = limerb <>
lindemans = lindemans <>
liux = liux <>
lopezrx = lopezrx <>
mayd = mayd <>
mcculloughr = mcculloughr <>
mcreynoldse = Eddie B. McReynolds <Eddie.McReynolds@crlcorp.com>
mediked = mediked <>
nadrowskim.priv = nadrowskim.priv <>
nelsonj = Joshua Nelson <Joshua.Nelson@crlcorp.com>
niedaj = niedaj <>
obrienj = Jim O'Brien <Jim.O'Brien@crlcorp.com>
oletis = Sunil Oleti <Sunil.Oleti@crlcorp.com>
ortizs = ortizs <>
patrickc = patrickc <>
paudelb = paudelb <>
paynej = paynej <>
pennya = Alan Penny <Alan.Penny@crlcorp.com>
porterj = porterj <>
porterjx = porterjx <>
quina = Alex Quin <Alex.Quin@crlcorp.com>
raghunathu = raghunathu <>
ringeisenr = ringeisenr <>
ringeisenrx = Randy Ringeisen <Randy.Ringeisen@crlcorp.com>
rosenbergJ = Justin Rosenberg <Justin.Rosenberg@crlcorp.com>
rosenbergj = Justin Rosenberg <Justin.Rosenberg@crlcorp.com>
rosenbergj@crlcorp.com = rosenbergj@crlcorp.com <>
ruhtert = ruhtert <>
scarboroughr = scarboroughr <>
scottc = scottc <>
scottc.priv = scottc.priv <>
shresthap = shresthap <>
smithje = smithje <>
snelld = snelld <>
steinmetzh = steinmetzh <>
stevensk = stevensk <>
sunt = sunt <>
suntx = suntx <>
suntx1 = suntx1 <>
suppenbachr = Robert Suppenbach <Robert.Suppenbach@crlcorp.com>
t_bowmane = t_bowmane <>
t_buit = t_buit <>
t_bushe = t_bushe <>
t_camerons = Susan Cameron <Susan.Cameron@crlcorp.com>
t_dandaj = t_dandaj <>
t_dlabald = t_dlabald <>
t_gaisand = t_gaisand <>
t_gandhik = t_gandhik <>
t_hagedornj = t_hagedornj <>
t_harootunianp = t_harootunianp <>
t_harootunip = t_harootunip <>
t_higginsk = t_higginsk <>
t_higginskr = t_higginskr <>
t_pickettp = t_pickettp <>
t_stevensk = t_stevensk <>
t_tangy = t_tangy <>
t_wagnerj = t_wagnerj <>
tany = tany <>
underwoodr = underwoodr <>
vankayalapar = vankayalapar <>
varneyb = varneyb <>
venkataramam = venkataramam <>
venkatj = venkatj <>
vittas = vittas <>
wagnerj = wagnerj <>
waltersg = waltersg <>
wansx = wansx <>
wetzelb = wetzelb <>
whitea = whitea <>
wildj = wildj <>
wildjx = wildjx <>
wilkesj = Jarrett Wilkes <Jarrett.Wilkes@crlcorp.com>
williamsb = williamsb <>
wilsons = wilsons <>
zewdez = zewdez <>
zhouc = zhouc <>
